###############
#.a.........s.#
#.......#....#
#.......#...#
#.......#v.#
#.......#####
#w.....s#
#########

#############
#..........##
#..^......##
#.........#
#####.....##############
###....................#
#......................#
###########............#
###########............#
#################......#
###################....#
####################...#
####################..s#
########################